[Map size]
M=70
N=70

[Node]
1,10,5,2,8 
2,10,15,1,8,7,3 
3,10,25,2,7,6,4,5 
4,7,35,3,5 
5,22,35,3,4,6,11 
6,30,25,3,5,11,14,10,7 
7,25,15,2,3,6,10,9,8 
8,25,5,1,2,7,9 
9,35,5,8,7,10,13,12 
10,35,15,7,9,13,6,14 
11,35,35,5,6,14,15 
12,45,5,9,13,22,23 
13,45,15,12,9,10,14,19,22 
14,45,30,13,19,17,15,11,6,10 
15,45,37,11,14,17 
16,65,35,17,18,20 
17,52,32,14,15,19,18,16 
18,57,32,19,20,16,17 
19,55,25,13,22,21,20,18,17,14 
20,65,25,21,19,18,16 
21,65,15,23,22,19,20 
22,55,15,12,23,13,21,19 
23,60,5,12,22,21 