[Map size]
m=4
n=4

[Node]
1 1 1 2 5 6 
2 1 2 1 5 6 7 3 
3 1 3 2 6 7 8 4 
4 1 4 3 7 8 
5 2 1 1 2 6 10 9 
6 2 2 1 2 3 7 11 10 9 5 
7 2 3 2 3 4 8 12 11 10 6 
8 2 4 4 3 7 11 12 
9 3 1 5 6 10 14 13 
10 3 2 5 6 7 11 15 14 13 9 
11 3 3 6 7 8 12 16 15 14 10 
12 3 4 8 7 11 15 16 
13 4 1 9 10 14 
14 4 2 13 9 10 11 15 
15 4 3 14 10 11 12 16 
16 4 4 15 11 12 
17 4 5 15 16 16 17 